//tile(sprite_index,height,passable), each entry is a tile stack, each row a row
15 10
16,0,1	16,0,1	16,0,1	16,0,1	16,0,1	16,0,1	16,0,1	16,0,1	16,0,1	16,0,1	16,0,1	16,0,1	16,0,1	0,2,1	16,0,1
16,0,1	0,2,1	16,0,1	16,0,1	16,0,1	16,0,1	16,0,1	16,0,1	16,0,1	16,0,1	16,0,1	16,0,1	16,0,1	16,0,1	16,0,1
16,0,1	16,0,1	0,2,1|0,2,1	16,0,1	0,2,1|1,1,1	16,0,1	16,0,1	16,0,1	16,0,1	16,0,1	16,0,1	16,0,1	16,0,1	16,0,1	16,0,1
16,0,1	0,2,1	16,0,1	16,0,1	16,0,1	16,0,1	16,0,1	16,0,1	16,0,1	16,0,1	16,0,1	16,0,1	16,0,1	16,0,1	16,0,1
16,0,1	16,0,1	16,0,1	16,0,1	16,0,1	16,0,1	16,0,1	16,0,1	16,0,1	0,2,1|1,1,1	16,0,1	16,0,1	16,0,1	16,0,1	16,0,1
16,0,1	16,0,1	16,0,1	16,0,1	16,0,1	16,0,1	16,0,1	16,0,1	16,0,1	16,0,1	16,0,1	16,0,1	16,0,1	16,0,1	16,0,1
16,0,1	16,0,1	16,0,1	16,0,1	16,0,1	16,0,1	16,0,1	16,0,1	16,0,1	16,0,1	16,0,1	16,0,1	16,0,1	16,0,1	16,0,1
16,0,1	16,0,1	16,0,1	16,0,1	16,0,1	16,0,1	16,0,1	16,0,1	16,0,1	16,0,1	16,0,1	16,0,1	16,0,1	16,0,1	16,0,1
0,2,1|0,2,1	16,0,1	16,0,1	16,0,1	16,0,1	16,0,1	16,0,1	16,0,1	16,0,1	16,0,1	16,0,1	16,0,1	16,0,1	16,0,1	16,0,1
16,0,1	16,0,1	16,0,1	16,0,1	16,0,1	16,0,1	16,0,1	16,0,1	16,0,1	16,0,1	16,0,1	16,0,1	16,0,1	16,0,1	16,0,1
