//tile(sprite_index,height,passable), each entry is a tile stack, each row a row
15 10
1,1,1                   1,1,1             1,1,1             1,1,1       1,1,1 1,1,1 1,1,1 1,1,1 1,1,1 1,1,1
1,1,1                   1,1,1             1,1,1             1,1,1       1,1,1 1,1,1 1,1,1 1,1,1 1,1,1 1,1,1
1,1,1                   1,1,1             1,1,1             1,1,1       1,1,1 1,1,1 1,1,1 1,1,1 1,1,1 1,1,1
1,1,1                   1,1,1             1,1,1             1,1,1       1,1,1 1,1,1 1,1,1 1,1,1 1,1,1 1,1,1
1,1,1                   1,1,1             1,1,1             1,1,1       1,1,1 1,1,1 1,1,1 1,1,1 1,1,1 1,1,1
4,2,1                   4,2,1             4,2,1             4,2,1       4,2,1 1,1,1 1,1,1 1,1,1 1,1,1 1,1,1
3,2,1|1,1,1             3,2,1|1,1,1       3,2,1|1,1,1       3,2,1|1,1,1 4,2,1 1,1,1 1,1,1 1,1,1 1,1,1 1,1,1
3,2,1|3,2,1|1,1,1       3,2,1|3,2,1|1,1,1 3,2,1|3,2,1|1,1,1 3,2,1|1,1,1 4,2,1 1,1,1 1,1,1 1,1,1 1,1,1 1,1,1
3,2,1|3,2,1|4,2,1       3,2,1|3,2,1|4,2,1 3,2,1|3,2,1|1,1,1 3,2,1|1,1,1 4,2,1 1,1,1 1,1,1 1,1,1 1,1,1 1,1,1
3,2,1|3,2,1|3,2,1|1,1,1 3,2,1|3,2,1|4,2,1 3,2,1|3,2,1|1,1,1 3,2,1|1,1,1 4,2,1 1,1,1 1,1,1 1,1,1 1,1,1 1,1,1
1,1,1                   1,1,1             1,1,1             1,1,1       1,1,1 1,1,1 1,1,1 1,1,1 1,1,1 1,1,1
1,1,1                   1,1,1             1,1,1             1,1,1       1,1,1 1,1,1 1,1,1 1,1,1 1,1,1 1,1,1
1,1,1                   1,1,1             1,1,1             1,1,1       1,1,1 1,1,1 1,1,1 1,1,1 1,1,1 1,1,1
1,1,1                   1,1,1             1,1,1             1,1,1       1,1,1 1,1,1 1,1,1 1,1,1 1,1,1 1,1,1
1,1,1                   1,1,1             1,1,1             1,1,1       1,1,1 1,1,1 1,1,1 1,1,1 1,1,1 1,1,1
